NO ./ressources/panblack.xpm
SO ./ressources/panbook.xpm
WE ./ressources/pancase1.xpm
EA ./path_to_the_east_texture.xpm


C 255,255,255
F 220,255,255

111111111111111111111111
100000000000000000000001
100000000000000000000001
111111111111110000000001
111111111111110000000001
1000000000000000E0000001
100000000000000000000001
100000000111111111111111
111111000000000000000001
111111111111111111111111