
NO ./ressources/panblack.xpm
SO ./ressources/panbook.xpm



WE ./ressources/pancase1.xpm




EA ./ressources/panel1.xpm





F 98,56,50


C 67,30,25

                         1
                        111
                       11011
                      1100011
                    111000000111
                  11110000000001111
                 1110000000000001111
                11110000000000000111
                111110000000000111111
                11111000000000011111
                  1111100000011111
                   11110E00000111
                     110000001111
                      111111111
                       1111111
                        11111
                         111
                          1