NO ./ressources/stone_wall.xpm
SO ./ressources/redbrick.xpm
WE ./ressources/greystone.xpm
EA ./ressources/wood.xpm

F 72,223,221
C 55,56,16

111111
100001
100001
100011
100001
10W001   1111
10000111111111111111111111
1000000000000000000000011
100000000111100000000000111
10000000000001111100000111
1111111111111111111111111