NO ./ressources/stone_wall.xpm
SO ./ressources/redbrick.xpm
WE ./ressources/greystone.xpm
EA ./ressources/grass.xpm

F 61,226,95
C 93,171,222

111111
100001
100001
100011
100001
100001   1111
10000111111111111111111111
1000000000000000000000011
10000000W111100000000000111
10000000000001111100000111
1111111111111111111111111