NO ./ressources/A-brown4.xpm
SO ./ressources/WoodSkul.xpm
WE ./ressources/gstfont1.xpm
EA ./ressources/zzwolf10.xpm

F 61,226,95
C 93,171,222

111111
100001
100001
100011
100001
100001   1111
10000111111111111111111111
100000N000000000000000011
10000001111000000000000111
10000000000001111100000111
101111111111111111111111
1001
10001
11111111111111111111111111
111
1111
