NO ./ressources/panblack.xpm
SO ./ressources/panbook.xpm
WE ./ressources/pancase1.xpm
EA ./ressources/panel1.xpm


F 250,100,177
C 111,176,234

111111
100101
101001
1100W1
111111