NO ./ressources/sand_floor.xpm
SO ./ressources/stone_wall.xpm
WE ./ressources/wood.xpm
EA ./ressources/stone_wall.xpm


F 250,100,177
C 111,176,234

111111
100101
101001
1100N1
111111