NO ./ressources/stone_wall.xpm
SO ./ressources/stone_wall.xpm
WE ./ressources/stone_wall.xpm
EA ./ressources/stone_wall.xpm


F 250,100,177
C 111,176,234

111111
100001
100001111
 111000111
  111100001
11000011111
11000111111111111111111111
10000W000000000000000000011
10000000010110000000000011
10000000000001111100000111
1111111111111111111111111

