NO ./ressources/A-brown4.xpm
SO ./ressources/WoodSkul.xpm
WE ./ressources/gstfont1.xpm
EA ./ressources/zzwolf10.xpm
C 255,255,255
F 220,255,255


        111111111111111111111111
      1100000000011000000000001
11111111111100000111000000000001
        101000000000000000000001
11111111110000011100000000000011
1000000001100000111011111111110011111
 111110111111111011100000011111111
111111111111110111010100100001
11000000111110010111000000100000000000000000000000000000000001
10000000000000011000N00100011
100000000000000011010100100011
11000001110101011111011110001
11110111 111011 101111010001
11111111 1111111 11111111111

111111111111111
10100000000000011
100000000000000001
11111111111111111
