
NO ./ressources/panblack.xpm
SO ./ressources/panbook.xpm



WE ./ressources/pancase1.xpm




EA ./ressources/panel1.xpm





F 98,56,50


C 67,30,25

111111 111111111111111111111111111111111111111111111111111111111111
1001011100000011111000000000000000000000000000000000000000000011111111111111111
101000000000000000000000000000000000000000000000000000000001111111111011110111111
1100W11111111111111110000000000000000111111111111111111111111111111
11111111111111111111111111111111111111111111111111111111111111111111111111111
111111111