111111111
100000000
111110001
100000N01
111111111