1111111111
1111111111
1111111111
1111111111
1111N11111
1111111111