NO ./ressources/panblack.xpm
SO ./ressources/panbook.xpm
WE ./ressources/pancase1.xpm
EA ./ressources/panel1.xpm
   
C 255,255,255
F 220,255,255


   111111111111111111111111
   1100000000011000000000001111
11111111111100000111000000000001
10100000000000000000000001111111              
11111111110000011100000000000011                
1000000001100000111011111111110011111           
111110111111111011100000011111111               
111111111111110111010100100001111111111      
1100001011111001011100N00010011
1000000010011000110011011100011   
10000010100000011010101100011
11000001110101011111011110001
11110111 111011 101111010001
11111111 1111111 11111111111
