NO ./path_to_the_north_texture

SO ./path_to_the_south_texture
WE ./path_to_the_west_texture
EA ./path_to_the_east_texture
   
C 255,255,255
F 220,255,255


        1111111111111111111111111
        1000000000110000000000001
        1011000001110000000000001
        1001000000000000000000001
111111111011000001110000000000001
100000000011000001110111111111111
11110111111111011100000010001
111101111111110111010100100011111111111111
110000001101010111000000100000000000000001
100000000000E00011000000100011111111111111
10000000000000001101010010001
1100000111010101111101111000111
11110111 1110101 101111010001
11111111 1111111 111111111111