NO ./path_to_the_north_texture

SO ./path_to_the_south_texture
WE ./path_to_the_west_texture
EA ./path_to_the_east_texture
   
C 255,255,255
F 220,255,255


        111111111111111111111111
        100000000011000000000001
     101101100000111000000000001
        101000000000000000000001
111111111110000011100000000000011
100000000011000001110111111111111
1111011111111101110000001000001
111101111111110111010100100001
11000000110101011100000010001
100000000000E0001100000010001
100000000000000011010100100011
11000001110101011111011110001
11110111 1110100 101111010001
11111111 1111111 11111111111
