NO ./ressources/panblack.xpm
SO ./ressources/panbook.xpm
WE ./ressources/pancase1.xpm
EA ./ressources/panel1.xpm


C 67,30,25

111111
100101
101001
1100N1
100001
111101
100001
111101
111111