
NO ./ressources/panblack.xpm
SO ./ressources/panbook.xpm



WE ./ressources/pancase1.xpm




EA ./ressources/panel1.xpm





F 98,56,50


C 67,30,25


111111
100101
101001
1100N1
111111
100001
100001
111111

111111
100001
100001
100001
111111

popo